11 7 7 7 7 7 7 7 7 15 7 7 7 7 7 12
6 0 1 2 0 1 2 0 1 2 0 1 2 0 1 13
6 1 2 0 1 2 0 1 2 0 1 2 0 1 2 13
6 2 0 1 2 0 1 2 0 1 2 0 1 2 0 13
6 1 2 0 1 2 0 1 2 0 1 2 0 1 2 13 
6 2 0 1 2 0 1 2 0 1 2 0 1 2 0 13
6 0 1 2 0 1 2 0 1 2 0 1 2 0 1 13
6 1 2 0 1 2 0 1 2 0 1 2 0 1 2 13
6 2 0 1 2 0 1 2 0 1 2 0 1 2 0 13
6 0 1 2 0 1 2 0 1 2 0 1 2 0 1 13
6 1 2 0 1 2 0 1 2 0 1 2 0 1 2 13
9 8 16 8 8 8 8 8 8 8 8 8 8 8 8 10