11 7 7 7 7 7 7  7  7  15 7  7  7  7  7  7  7  7  7  7  7  7  7  7  7  7  7  7  7  7 7 7 7 7 7 7 7 7 7 7 7 7 7 7 7 7 7 7 7 12
6  0  19 2  0  1  2  0  19 17 19 1  2  0  1  2  0  1  2  0  1  2  0  1  2  0  19 2  0  1 2 0 1 2 0 1 2 0 1 2 0 1 19 0 1 2 0 1 2 13
6  1  17 17 17 17 17 17 17 17 1  2  0  1  2  0  19 2  0  1  2  0  1  2  0  1  2  0  19 2 0 1 2 0 1 2 0 1 2 0 1 2 0 1 2 0 1 2 0 13
6  2  17 17 2  0  1  2  0  1  2  0  1  2  0  1  2  0  1  2  0  1  2  0  19 2  0  1  2  0 1 2 0 1 2 0 1 2 0 1 2 0 1 2 0 1 2 0 1 13
6  1  17 17 11 7  7  7  7  7  7  7  7  7  7  7  7  7  7  7  7  7  7  7  7  7  7  7  7  7 7 7 7 7 7 7 7 7 7 7 7 7 7 7 7 7 7 7 7 13 
6  2  17 17 6  3  4  5  3  4  5  3  4  5  3  4  5  3  4  5  3  4  5  3  4  5  3  4  5  3 4 5 3 4 5 3 4 5 3 4 5 3 4 5 3 4 5 3 4 13
6  0  17 17 6  5  3  4  5  3  4  5  3  4  5  3  4  5  3  4  5  3  4  5  3  4  5  3  4  5 3 4 5 3 4 5 3 4 5 3 4 5 3 4 5 3 4 5 3 13
6  1  17 17 6  4  5  3  4  5  3  4  5  3  4  5  3  4  5  3  4  5  3  4  5  3  4  5  3  4 5 3 4 5 3 4 5 3 4 5 3 4 5 3 4 5 3 4 5 13
6  2  17 17 9  8  8  8  8  8  8  8  8  8  8  8  8  8  8  8  8  8  8  8  8  8  8  8  8  8 8 8 8 8 8 8 8 8 8 8 8 8 8 8 8 8 8 8 8 13
6  0  17 17 17 17 17 17 17 17 17 17 17 17 17 17 17 17 17 17 17 17 17 17 17 17 17 17 17 17 17 17 17 17 17 17 17 17 17 17 17 17 17 17 17 17 17 17 17 13
6  19 17 17 17 17 17 17 17 17 17 17 17 17 17 17 17 17 17 17 17 17 17 17 17 17 17 17 17 17 17 17 17 17 17 17 17 17 17 17 17 17 17 17 17 17 17 17 17 13
9  8  8  8  8  8  8  8  8  8  8  8  8  8  8  8  8  8  8  8  8  8  8  8  8  8  8  8  8  8  8  8  8  8  8  19 17 17 17 19 8 8 8 8 8 8 8 8 8 10
0  1  2  0  1  2  0  1  2  0  1  2  0  1  2  0  1  2  0  1  2  0  1  2  0  1  2  0  1  2  0  1  2  0  1  2  0  1  2  0  1 2 0 1 2 0 1 2 0 1